$ tail опции файл

-c - выводить указанное количество байт с конца файла;
-f - обновлять информацию по мере появления новых строк в файле;
-n - выводить указанное количество строк из конца файла;
--pid - используется с опцией -f, позволяет завершить работу утилиты, когда завершится указанный процесс;
-q - не выводить имена файлов;
--retry - повторять попытки открыть файл, если он недоступен;
-v - выводить подробную информацию о файле;


$ wc file

-c	--bytes	Отобразить размер объекта в байтах
-m	--count	Показать количесто символов в объекте
-l	--lines	Вывести количество строк в объекте
-w	--words	Отобразить количество слов в объекте


$ sort опции файл

$ команда | sort опции

-b - не учитывать пробелы
-d - использовать для сортировки только буквы и цифры
-i - сортировать только по ASCII символах
-n - сортировка строк linux по числовому значению
-r - сортировать в обратном порядке
-с - проверить был ли отсортирован файл
-o - вывести результат в файл
-u - игнорировать повторяющиеся строки
-m - объединение ранее отсортированных файлов
-k - указать поле по которому нужно сортировать строки, если не задано, сортировка выполняется по всей строке.
-f - использовать в качестве разделителя полей ваш символ вместо пробела.




$ uniq опции файл_источник файл_для_записи

echo -e [текст, слова в котором разделены управляющей последовательностью\\n] | uniq


Команда uniq предназначена для поиска одинаковых строк в массивах текста. При этом с найденными совпадениями пользователь может совершать множество действий — например, удалять их из вывода либо наоборот, выводить только их.


-u (--unique) — выводит исключительно те строки, у которых нет повторов.
-d (--repeated) — если какая-либо строка повторяется несколько раз, она будет выведена лишь единожды.
-D — выводит только повторяющиеся строки.
--all-repeated[=МЕТОД] — то же самое, что и -D, но при использовании этой опции между группами из одинаковых строк при выводе будет отображаться пустая строка. [=МЕТОД] может иметь одно из трех значений — none (применяется по умолчанию), separate или prepend.
--group[=МЕТОД] — выводит весь текст, при этом разделяя группы строк пустой строкой. [=МЕТОД] имеет значения separate (по умолчанию), prepend, append и both, среди которых нужно выбрать одно.


-f (--skip-fields=N) — будет проведено сравнение полей, начиная с номера, который следует после указанного вместо буквы N. Поля — это слова, хотя, называть их словами в прямом смысле слова нельзя, ведь словом команда считает любую последовательность символов, отделенную от других последовательностей пробелом либо табуляцией.
-i (--ignore-case) — при сравнении не будет иметь значение регистр, в котором напечатаны символы (строчные и заглавные буквы).
-s (--skip-chars=N) — работает по аналогии с -f, однако, игнорирует определенное количество символов, а не строк.
-c (--count) — в начале каждой строки выводит число, которое обозначает количество повторов.
-z (--zero-terminated) — вместо символа новой строки при выводе будет использован разделитель строк NULL.
-w (--check-chars=N) — указание на то, что нужно сравнивать только первые N символов в строках.
